{ 
  "levelNumber": 16, 
  "characterName": 0, 
  "characterStartCoords": [ 15, 7], 
  "wallsColor":"#6049ed", 
  "wallsType":0,
  "startHealth": 2000, 
  "startScore":  0, 
  "width": 33, 
  "height": 33, 
  "array": [ 
    [ 7,13,13,13,13,13,13,13, 7,13,13, 7,13,13,13,13,13,13,13,13,13,13,13,13,13, 7,13,13,13, 7,13,13,19],
    [14, 0, 0, 0, 0,32, 0,22, 1,22,22,14, 0, 0, 0, 0, 0,32, 0, 0,73,73, 0, 0, 0, 1,22,22,22, 1,70,70,14],
    [14, 0, 0,74, 3, 0, 0, 0, 0, 0, 0,14,22,22, 2,13,13,13,13,13,13, 4,73,15,-84,32, 0, 0, 0, 0, 0, 0,14],
    [14, 0, 9,13, 5,13,13,13, 7, 4, 0,14,22, 3, 0, 0, 0, 0, 0, 0, 0, 0, 3,73, 2, 7,13,13,13, 7, 4, 0,14],
    [14, 0,14,73, 0, 0, 0, 0,14, 0, 0,14,30, 1, 0, 0, 2, 4, 0,15, 0, 0, 1, 0, 0,14, 0, 0, 0,14, 0, 0,14],
    [14, 0,14, 0, 0, 3, 0, 0,14, 0, 0,14,34,31,15,34, 0, 0,15,22,15, 0, 0, 3, 0,14, 0, 3, 0,14, 0, 0,14],
    [14, 0, 6, 4, 0,14, 0, 2, 8, 0, 0,14, 0,31,-85, 2, 4, 0, 0, 3,70, 3,32,14, 0, 1, 0,14, 0,14, 0, 0,14],
    [14, 0,14, 0, 0,14, 0, 0,14, 0, 0,14, 0,31, 3, 0, 0, 3, 0,14, 0,14, 0, 1, 0, 0, 0,14, 0,14, 0, 0,14],
    [14, 0,14, 0, 0,14, 0, 0,14, 0, 0,14,29,31,14, 0, 0,14, 0,14, 0,14, 0,31,30,31, 0,14, 0,14, 0, 0,14],
    [ 8, 0,14,34, 2,19, 4, 0,14,30, 2,19,13,13,11, 0, 0,14, 0,14, 0,14, 0,31,-85,31, 0,14, 0,14, 0, 0,14],
    [14, 0,14, 0, 0,14, 0, 0,14, 0, 0, 1, 0, 0, 0, 0, 0,14,30,14, 0, 1, 0,31,30,30, 0,14, 0,14, 0, 0,14],
    [14, 0,14,73, 0,14, 0, 0,14, 0, 0, 0, 0, 0, 0, 0,32,14, 0, 1, 0, 0,15, 0, 0, 0, 0,14, 0,14, 0, 0,14],
    [14, 0,14, 0, 0,14, 0, 2,19,13,13,13,13,13, 7,13,13, 8, 0, 0,15, 0, 0,15, 0, 0, 0,14, 0,14, 0, 0,14],
    [14, 0,14, 0, 0,14, 0,-84,14,22,22, 0,32, 0,14,-84,-84,14,33, 0, 0,15, 0, 0, 2,13,13,11, 0,14, 0, 0,14],
    [14,22,14,26, 0,14, 0, 0, 1, 0, 0, 3, 0, 0,12,13,13,11,32, 0, 0, 0,15, 0,32, 0, 0,26, 0, 1, 0, 0,14],
    [14, 0,14, 0, 0,14, 0, 0, 0, 0, 0,14, 0, 0, 0, 0,34, 0, 2,13, 4, 0, 0, 0, 0, 0, 0, 0,26, 0, 3, 0,14],
    [14, 0,14, 0,32,12, 4,26, 9,13,13,19,13,13, 7,13, 4,21, 0, 0, 0, 2,13,13,13, 7,13,13, 4,26,14, 0,14],
    [14, 0,14, 0, 0,26,26, 2, 8, 0, 0, 1, 0, 0,14,21,34, 2,13, 4, 0, 0, 0, 0, 0, 1, 0, 0,33, 0,14, 0,14],
    [14, 0,14, 0, 9, 4, 0, 0,14, 0, 0, 0, 0, 0,14, 0, 0,22, 0,22, 3, 0, 0, 0, 0, 0, 0, 0, 0, 0, 1, 0,14],
    [14,22,14, 0,14, 0,15, 0,14, 0, 0, 2, 4,26,14, 0, 3, 0, 0, 2, 5,13, 7,13,13,13,13,13,13,10,33, 0,14],
    [ 8, 0,14, 0,14, 0,26,26,14,76,76, 0,26,73, 1, 0,14,22,15, 0, 0, 0, 1, 0,31, 0, 0,31,-85,14,22, 9, 8],
    [ 8, 0, 1, 0,14, 0, 2,13,11, 0, 0, 0,26, 0,26,22,12, 4, 0, 0,15, 0, 0, 0,31, 0,32,31,30,14, 0,12, 8],
    [14, 0,31, 0,14, 0, 0, 0, 0, 0, 0, 0,26,26, 0,15, 0, 0, 0,15, 0, 2,13,13,13, 4, 0, 0, 0,14,22, 0,14],
    [14, 0, 3,32,12, 7,13,13,13,13,13,13,13,13,10, 0, 0, 0,15, 0, 0, 0, 0, 0, 0,22, 2,10, 0, 6, 4, 0,14],
    [ 6,13,11, 0, 0, 1, 0, 0, 0, 0,22, 0, 0, 0, 1, 0, 0, 3, 0, 0, 0,32,15, 0,15, 0,22, 1, 0,14,33, 0,14],
    [14, 0, 0, 0, 0,26, 0, 0, 0,22, 3,22, 0, 0, 0, 0, 0, 1, 0, 0, 0,15, 0, 3,22, 0,15, 0, 0,14, 0, 0,14],
    [14, 0, 9,13,13, 7,13,13,10,30,12,13,13,13, 7,13, 4, 0, 0, 0,15, 0, 0, 1,36,15, 0,15, 0,14, 0, 0,14],
    [14, 0,14, 0, 0, 1,-84, 0,14, 0, 0, 0, 0, 0, 1, 0, 0, 0, 0,15, 0, 0, 3, 0,15, 0,15, 0, 0,14, 0,22,14],
    [ 8, 0, 1, 0,15, 0,15, 0, 1, 0, 3,75, 0, 0,32, 0, 0, 0,15, 0, 0, 0, 1, 0, 0, 0, 0, 0, 0,14, 0, 2, 8],
    [14, 0, 0, 0, 0, 0, 0,15,74, 2, 8,70, 2,13,13,13,13, 4, 0, 0, 0,15, 0, 9,13,13,13,13,13, 8, 0, 0,14],
    [14, 0, 0, 2, 4, 0,15, 0,15, 0,12, 4,34, 0, 0, 0, 0, 0, 0, 0, 0, 0, 0, 1, 0, 0, 0, 0, 0, 1, 0, 0,14],
    [14,26, 3,26, 0, 0, 0, 0, 0, 0, 0, 0, 0, 0, 0, 0, 0, 0,-85, 3, 0, 0, 0, 0, 0, 0, 3,70, 0,31, 0, 0,14],
    [19,13, 5,13,13,13,13,13, 7,13,13, 7,13,13,13,13,13,13,13, 5,13,13,13,13,13, 7, 5,13,13, 7,13,13,19]

  ] 
}