{ 
  "levelNumber": 8, 
  "characterName": 0, 
  "characterStartCoords": [ 16, 16 ], 
  "wallsColor":"#6049ed", 
  "wallsType":0,
  "startHealth": 2000, 
  "startScore":  0, 
  "width": 33, 
  "height": 33, 
  "array": [ 
    [ 7,13,13,13,13,13,13, 7,13,13,13,13,13,13,13, 7,13,13,13, 7,13,13,13, 7,13,13,13,13, 7,13,13,13, 8], 
    [14,33, 0, 0, 0, 0,26,14,22, 0, 0, 0, 0, 0, 0,14,26, 0, 0,14,26, 0,26,14,21, 0, 0,26,14, 0, 0,26,14], 
    [14,22, 0, 0, 0, 0, 0,14, 0, 0, 0, 0, 0, 0, 0,14, 0, 0,20,14, 0, 0, 0,12, 4, 0, 0, 0,14,22, 0, 0,14], 
    [ 6,13,13, 4, 0, 0, 0, 1, 0, 0, 0, 3, 0,37, 0,14, 0, 0, 2,11, 0, 0, 0, 0, 0, 0, 0, 0,12, 4, 0, 0,14], 
    [14,26, 0, 0, 0, 0, 0, 0, 0, 0, 0,14, 0, 0, 0,14, 0, 0, 0, 0, 0, 0, 0, 0, 0, 0, 0, 0, 0, 0, 0, 0,14], 
    [14, 0, 0, 0, 0, 0, 0, 0, 0, 0,26,14,22, 0, 0,14, 0, 0, 0, 0, 0, 0, 0, 9, 4, 0, 0, 0, 0, 0, 0, 0,14], 
    [14,22, 0, 0, 0, 9,13,13, 7,13,13, 5,10, 0, 0,14,33, 0, 2,10, 0, 0, 0,14,21, 0, 0, 0, 9, 4, 0, 0,14], 
    [14, 0, 0, 0, 0,14,21, 0,14,20, 0,26,14, 0, 0,14, 0, 0,20,14, 0, 0, 0,14, 0, 0, 0, 0,14,22, 0, 0,14], 
    [14, 0, 0, 0, 0,14, 0, 0, 1, 0, 0, 0,14, 0,33,14,36, 0, 0,14, 0, 0, 0,14, 0, 0, 0,26,14, 0, 0,33,14], 
    [19,13, 4, 0, 0,14, 0, 0, 0, 0, 0, 0,12,13,13, 5,13,13,13,11, 0, 0, 9, 5, 4, 0, 0, 9, 5,13,13,13, 8], 
    [14, 0, 0, 0, 0,14, 0, 0, 0, 0, 0, 0, 0, 0, 0, 0,20, 0, 0, 0, 0, 0,14, 0, 0, 0, 0, 1,21, 0, 0, 0,14], 
    [14, 0,21,21, 0,14,36, 0, 0, 0, 3, 0, 0, 0, 0, 0, 0, 0, 0, 0, 0, 9,11, 0, 0, 0, 0, 0, 0, 0, 0, 0,14],
    [14, 0, 0, 0, 0,12,13, 4, 0, 0,14, 0, 0, 0, 0, 0, 0, 0, 0, 0, 0,14,21, 0, 0, 0, 0, 0, 0, 0, 0,26,14], 
    [ 8, 0, 0, 0, 0, 0, 0, 0, 0, 0,14, 0, 0, 0,20,16,15,16, 0, 0, 0, 6,13,13,13,13,13,10, 0, 0, 9,13, 8], 
    [14,26, 0, 0, 0, 0, 0, 0, 0,26,14, 0, 0, 0,16, 0,29, 0,16, 0, 0,14,26,26, 0, 0,21, 1, 0, 0, 1, 0,14], 
    [ 6,13,13, 7,13,13,13, 7,13,13, 8, 0, 0, 0,16, 0, 0, 0,15, 0,20,14,26,26, 0, 0, 0, 0, 0, 0, 0, 0,14], 
    [14, 0,74,14, 0,75, 0,14,75, 0,14,20, 0, 0,15, 0, 0, 0,16, 0, 0,14,26,26,21, 0, 0, 0, 0, 0, 0, 0,14], 
    [ 8, 0, 0,14, 0, 0, 0, 1, 0, 0,14, 0, 0, 0,16, 0, 0, 0,16, 0, 0, 6,13,13, 7,13,13,13, 7,13,13,13, 8], 
    [14, 0, 0, 1, 0, 0, 0, 0, 0, 0,14, 0, 0, 0, 0,16,15,16,20, 0, 0,14,72, 0, 1,26, 0,72,14, 0, 0,72,14], 
    [14, 0, 0, 0, 0, 0, 0, 0, 0, 0,14, 0, 0, 0, 0, 0, 0, 0, 0, 0, 0, 1, 0, 0, 0, 0, 0, 0, 1, 0, 0, 0,14], 
    [14, 0, 0, 0, 0, 0, 0, 3, 0, 0, 1, 0, 0, 0, 0, 0,20, 0, 0, 0, 0, 0, 0, 0, 0, 0, 0, 0, 0, 0, 0, 0,14], 
    [14, 0, 0, 0, 3, 0,75,14, 0, 0, 0, 0, 0, 9,13,13,13, 7,13,10, 0, 0, 0,26, 3, 0, 0, 0, 0, 0, 0, 0,14],
    [14, 0, 0, 0,12,13,13, 8,34, 0, 0, 0, 0,14, 0, 0,74,14,71,12,13, 7,13,13, 8, 0, 0, 0, 9, 4, 0, 0,14], 
    [14,26, 0, 0, 0, 0, 0, 6,13,13,13, 7,13,11, 0, 0, 0,14, 0, 0, 0,14,71, 0,14, 0,72,26,14,72, 0, 0,14], 
    [ 6,13, 4, 0, 0, 0,74,14,26, 0, 0,14,74, 0, 0, 0, 0,14, 0, 0, 0,14, 0, 0,12,13,13, 7,11, 0, 0, 0,14], 
    [14, 0, 0,33, 0, 0, 0,14, 0, 0, 0, 1, 0, 0,15, 0, 0,14, 0, 0,71,14, 0, 0, 0, 0,71,14, 0, 0, 0, 0,14], 
    [14,74, 0, 0, 0, 2,13, 8, 0, 0, 0, 0, 0, 0, 0, 0,34,14, 0, 0, 2,11, 0, 0, 0, 0, 0,14, 0, 0, 0,26,14], 
    [ 8, 0, 0, 0, 0, 0,74,14, 0, 0, 0, 0, 0, 0, 0, 0, 0,14, 0, 0, 0, 0, 0,26, 0, 0, 2, 8, 0, 0, 9,13, 8], 
    [14,26, 0, 0, 0, 0, 0,14, 0, 0, 0, 0, 0, 0, 3, 0, 0,14, 0, 0, 0, 0, 0, 0, 0, 0, 0, 1, 0, 0, 1,71,14], 
    [ 6,13,13, 4, 0, 0, 2,11, 0, 0, 0, 3, 0, 0,14, 0, 0,14, 0, 0, 2,10, 0, 0, 0, 0, 0, 0, 0, 0, 0, 0,14], 
    [14,74, 0, 0, 0, 0, 0, 0, 0, 0, 0,14, 0, 0,14, 0, 0,14, 0, 0,71,14, 0, 0, 2,10, 0, 0, 0, 0, 0, 0,14], 
    [14, 0, 0, 0, 0, 0, 0, 0, 0,40,26,14,74, 0,14, 0,29,14, 0, 0, 0,14, 0, 0,71,14,71, 0, 0, 0, 0,33,14], 
    [19,13,13,13,13,13,13, 7,13,13,13, 5,13,13, 5, 7,13, 5,13, 7,13, 5,13, 7,13, 5,13,13, 7,13,13,13, 8] 
  ] 
}

